0	0	4620	1	0
0	0	2310	1	0
0	0	1155	1	0
0	0	578	1	0
0	0	289	0	1	68
289	0	289	0	9	12	13	19	20	21	68	81	82	94
289	289	289	0	9	13	14	10	140	71	109	110	92	101
0	289	289	0	14	6	3	4	5	11	10	9	8	7	2	67	70	90	91
578	0	578	1	0
578	0	289	0	15	21	22	23	29	24	25	18	17	82	72	73	94	111	112	124
867	0	289	0	11	29	30	24	26	27	28	82	73	102	95	113
867	289	289	0	5	26	34	35	74	75
578	289	289	0	6	15	10	16	71	72	93
578	578	578	0	0
0	578	578	1	0
0	578	289	0	7	0	1	2	5	69	67	70
289	578	289	0	0
289	867	289	0	0
0	867	289	0	0
1155	0	1155	1	0
1155	0	578	1	0
1155	0	289	0	8	30	31	32	33	36	82	83	84
1444	0	289	0	3	36	37	84
1444	289	289	0	10	37	35	38	39	40	41	75	76	103	97
1155	289	289	0	7	34	35	141	75	114	96	115
1733	0	578	1	0
1733	0	289	0	0
2022	0	289	0	0
2022	289	289	0	3	46	47	86
1733	289	289	0	5	37	38	46	85	86
1733	578	578	1	0
1733	578	289	0	5	43	44	45	77	116
2022	578	289	0	8	45	48	47	77	104	105	117	98
2022	867	289	0	0
1733	867	289	0	0
1155	578	578	1	0
1155	578	289	0	0
1444	578	289	0	5	41	42	43	76	77
1444	867	289	0	0
1155	867	289	0	0
1155	1155	1155	0	0
0	1155	1155	0	0
2310	0	2310	1	0
2310	0	1155	1	0
2310	0	578	1	0
2310	0	289	0	0
2599	0	289	0	2	58	88
2599	289	289	0	9	49	50	52	51	53	60	78	79	127
2310	289	289	0	4	49	46	87	86
2888	0	578	1	0
2888	0	289	0	2	58	88
3177	0	289	0	2	58	88
3177	289	289	0	8	53	61	89	56	55	79	121	106
2888	289	289	0	7	53	61	89	54	79	120	119
2888	578	578	0	0
2310	578	578	1	0
2310	578	289	0	6	45	47	49	77	118	99
2599	578	289	0	6	45	49	50	51	77	78
2599	867	289	0	0
2310	867	289	0	0
3465	0	1155	1	0
3465	0	578	1	0
3465	0	289	0	2	58	88
3754	0	289	0	3	58	63	88
3754	289	289	0	8	63	62	53	79	107	108	123	130
3465	289	289	0	6	53	57	59	79	100	122
4043	0	578	1	0
4043	0	289	0	2	63	88
4332	0	289	0	3	63	66	88
4332	289	289	0	8	63	62	64	65	80	78	129	131
4043	289	289	0	3	63	62	79
4043	578	578	1	0
4043	578	289	0	6	132	133	134	135	142	143
4332	578	289	0	5	136	137	138	139	144
4332	867	289	0	0
4043	867	289	0	0
3465	578	578	0	0
3465	1155	1155	0	0
2310	1155	1155	0	0
2310	2310	2310	0	0
0	2310	2310	0	0